11111111111111111111111111111111111111111111111111
10000000000000000000000000000000000000000000000001
10000000000000000000000000000000000000000000000001
10000000000000000000000000P00000000000000000000001
1000000E000000000000000000000000000000000000000001
100000000000000000C0C00000000000000000000000000001
10000000000000000000000000000000000000000000000001
10000000000000000000000000000000000000000000000001
1000000000000000000000000C000000000000000000000001
10000000000000000000000011111111111111111111111111
1000000000000000000000001
1000000000000000000000001
1000000000000000000000001
1000000000000000000000001
1000000E00000000000000001
100000000000000000C0C0001
1000000000000000000000001
1000000000000000000000001
1000000000000000000000001
1111111111111111111111111