





111111111111111111111111111111111
100000000000000000000000000000001
100000000000000000000000000000001
10000000000000000000000000P000001
1000000E0000000000000000000000001
100000000000000000C0C000000000001
100000000000000000000000000000001
100000000000000000000000000000001
1000000000000000000000000C0000001
111111111111111111111111111111111



