11111111111111111111111111111111111111111111111111
10000000000100000000000000000000000000000000000001
10000000000100000000000000000000000000000000000001
10000000000100000000000000P00000000000000000000001
1000000E000100000000000000000000000000000000000001
100000000001000000C0C00000000000000000000000000001
10000000000100000000000000000000000000000000000001
10000000000100000000000000000000000000000000000001
1000000000010000000000000C000000000000000000000001
11111111111111111111111111111111111111111111111111