111111111111111
10010C100010E01
1P0010101110111
100000100000001
101000000010001
111111111111111