

111111111111111
10010C10M010E01
1P0010101110111
100000100000001
101000M00010M01
111111111111111