1111111111111111111111
1100000000110000000001
1110000011100001110001
1000000000000000C00001
100P000000111001000001
1110001100001001100001
100000010E001111100001
1011000100001100C00001
111C000111111000001111
1000011100C10000000101
1000000000000000000001
1111111111111111111111