1111111111111111111111
1100C000000000M0000001
1110000000111111110001
1000111100000111000001
10M000111100001100C011
10011001000E0001000011
1000000100000111000001
100P0000C0000000000001
1000000000000001111001
1000001111111000000001
10C000M000011111110C01
1111111111111111111111