1111111111111111111111
1000C00000M00000000001
1001111110000000C00001
1000000111111110000001
100P000000001000000001
1000000000C01000001001
100001110000100M001001
100111M000001000001101
11110000000000C0000111
1000E000C1111000000001
10000001110000000C0001
1111111111111111111111