1111111111111111111
11C01111111000E0001
1100011000000000011
1111010001000000101
1P00000011110011001
1111000000010000001
1000000001110001001
1111110000C100110C1
1111111111111111111
