11111111111
1000E000001
1000000C000
10P00000001
11111111111
