11111111
10P00001
10000001
11111111
