11111111111
10000E10001
10P0010C001
10001000001
11111111111
