111111
10P0C11
100E001
11111111
